






  
SO    ./textures/wood.xpm
EA ./textures/wall_1.xpm
C 0,0,255
NO ./textures/wall_2.xpm
   WE ./textures/wall_4.xpm



F             21,32,11






          

11   11
1111111111111
11000000000001
  110000N000011
1 1001111110111
11001000010111
110010001000111
1100100000111
1100111111111                                1
11111111111
111111
